name	county	type	wikipedia_link
Almonry Museum and Heritage Centre	in_Worcestershire	Local	/wiki/Almonry_Museum_and_Heritage_Centre
Avoncroft Museum of Historic Buildings	in_Worcestershire	Other	/wiki/Avoncroft_Museum_of_Historic_Buildings
Bewdley Museum	in_Worcestershire	Multiple	/wiki/Bewdley_Museum
Bredon Barn	in_Worcestershire	Historic	/wiki/Bredon_Barn
Churchill Forge Mill	in_Worcestershire	Industrial	/wiki/Churchill_Forge_Mill
Commandery	in_Worcestershire	Historic	/wiki/The_Commandery
Croome Park	in_Worcestershire	Historic	/wiki/Croome_Park
Droitwich Spa Heritage Centre	in_Worcestershire	Local	/w/index.php?title=Droitwich_Spa_Heritage_Centre&action=edit&redlink=1
Elgar Birthplace Museum	in_Worcestershire	Historic	/wiki/Elgar_Birthplace_Museum
Forge Mill Needle Museum	in_Worcestershire	Industrial	/wiki/Forge_Mill_Needle_Museum
George Marshall Medical Museum	in_Worcestershire	Other	/w/index.php?title=George_Marshall_Medical_Museum&action=edit&redlink=1
Gordon Russell Museum	in_Worcestershire	Arts	/w/index.php?title=Gordon_Russell_Museum&action=edit&redlink=1
The Greyfriars	in_Worcestershire	Historic	/wiki/The_Greyfriars
Hagley Hall	in_Worcestershire	Historic	/wiki/Hagley_Hall
Hanbury Hall	in_Worcestershire	Historic	/wiki/Hanbury_Hall
Harvington Hall	in_Worcestershire	Historic	/wiki/Harvington_Hall
The Infirmary	in_Worcestershire	Other	/w/index.php?title=The_Infirmary&action=edit&redlink=1
Kidderminster Railway Museum	in_Worcestershire	Transport	/w/index.php?title=Kidderminster_Railway_Museum&action=edit&redlink=1
Little Malvern Court	in_Worcestershire	Historic	/wiki/Little_Malvern_Priory
Madresfield Court	in_Worcestershire	Historic	/wiki/Madresfield_Court
Malvern Museum	in_Worcestershire	Local	/wiki/Malvern_Museum
Middle Littleton Tythe Barn	in_Worcestershire	Historic	/wiki/Middle_Littleton_Tythe_Barn
Military Wireless Museum in the Midlands	in_Worcestershire	Other	/wiki/Military_Wireless_Museum_in_the_Midlands
Morgan Motor Company	in_Worcestershire	Transport	/wiki/Morgan_Motor_Company
Museum of Carpet	in_Worcestershire	Industrial	/w/index.php?title=Museum_of_Carpet&action=edit&redlink=1
Pershore Heritage Centre	in_Worcestershire	Local	/w/index.php?title=Pershore_Heritage_Centre&action=edit&redlink=1
Stourport Canal Basins	in_Worcestershire	Transport	/w/index.php?title=Stourport_Canal_Basins&action=edit&redlink=1
Tenbury Museum	in_Worcestershire	Local	/wiki/Tenbury_Museum
Transport Museum, Wythall	in_Worcestershire	Transport	/wiki/The_Transport_Museum,_Wythall
Tudor House Heritage Centre	in_Worcestershire	Historic	/w/index.php?title=Tudor_House_Heritage_Centre&action=edit&redlink=1
Tudor House Museum	in_Worcestershire	Local	/w/index.php?title=Tudor_House_Museum,_Upton-upon-Severn&action=edit&redlink=1
Worcester City Art Gallery & Museum	in_Worcestershire	Multiple	/wiki/Worcester_City_Art_Gallery_%26_Museum
Worcester Porcelain Museum	in_Worcestershire	Arts	/wiki/Worcester_Porcelain_Museum
Worcestershire County Museum at Hartlebury Castle	in_Worcestershire	Multiple	/wiki/Worcestershire_County_Museum
Worcestershire Masonic Library & Museum	in_Worcestershire	Other	/w/index.php?title=Worcestershire_Masonic_Library_%26_Museum&action=edit&redlink=1
