name	county	type	wikipedia_link
American Museum in Britain	in_Somerset	Arts	/wiki/American_Museum_in_Britain
Ashton Windmill	in_Somerset	Industrial	/wiki/Ashton_Windmill
Bakelite Museum	in_Somerset	Multiple	/wiki/Bakelite_Museum
Barrington Court	in_Somerset	Historic	/wiki/Barrington_Court
Bath Abbey Heritage Vaults Museum	in_Somerset	Other	/wiki/Bath_Abbey#Heritage_Vaults_Museum
Bath Postal Museum	in_Somerset	Other	/wiki/Bath_Postal_Museum
Bath Royal Literary and Scientific Institution	in_Somerset	Multiple	/wiki/Bath_Royal_Literary_and_Scientific_Institution
Beckford's Tower and Museum	in_Somerset	Local	/wiki/Beckford%27s_Tower
Bishops Lydeard Mill and Rural Life Museum	in_Somerset	Industrial	/wiki/Bishops_Lydeard_Mill_and_Rural_Life_Museum
Bishop's Palace	in_Somerset	Historic	/wiki/Bishop%27s_Palace,_Wells
Blagdon Lake Pumping Station and Visitor Centre	in_Somerset	Other	/wiki/Blagdon_Lake
Blake Museum	in_Somerset	Local	/wiki/Blake_Museum
Blue Anchor Railway Museum	in_Somerset	Transport	/wiki/Blue_Anchor_railway_station#Museum
Bruton Museum	in_Somerset	Local	/wiki/Bruton_Museum
Castle Cary and District Museum	in_Somerset	Local	/wiki/Castle_Cary_and_District_Museum
Chard Museum	in_Somerset	Local	/wiki/Chard_Museum
Cheddar Caves and Gorge	in_Somerset	Historic	/wiki/Cheddar_Gorge
Claverton Pumping Station	in_Somerset	Other	/wiki/Claverton_Pumping_Station
Cleeve Abbey	in_Somerset	Other	/wiki/Cleeve_Abbey
Clevedon Court	in_Somerset	Historic	/wiki/Clevedon_Court
Coleridge Cottage	in_Somerset	Historic	/wiki/Coleridge_Cottage
Cothay Manor	in_Somerset	Historic	/wiki/Cothay_Manor
Crewkerne and District Museum	in_Somerset	Local	/wiki/Crewkerne_and_District_Museum
Dunster Castle	in_Somerset	Historic	/wiki/Dunster_Castle
Dunster Museum & Doll Collection	in_Somerset	Arts	/wiki/Dunster_Museum_%26_Doll_Collection
Dunster Working Watermill	in_Somerset	Industrial	/wiki/Dunster_Working_Watermill
East Somerset Railway	in_Somerset	Transport	/wiki/East_Somerset_Railway
Farleigh Hungerford Castle	in_Somerset	Historic	/wiki/Farleigh_Hungerford_Castle
Fashion Museum, Bath	in_Somerset	Arts	/wiki/Fashion_Museum,_Bath
Fleet Air Arm Museum	in_Somerset	Transport	/wiki/Fleet_Air_Arm_Museum
Frome Museum	in_Somerset	Local	/wiki/Frome_Museum
Fyne Court	in_Somerset	Historic	/wiki/Fyne_Court
Gants Mill	in_Somerset	Industrial	/wiki/Gants_Mill
Glastonbury Abbey	in_Somerset	Local	/wiki/Glastonbury_Abbey
Glastonbury Lake Village Museum	in_Somerset	Historic	/wiki/The_Tribunal,_Glastonbury
Haynes International Motor Museum	in_Somerset	Transport	/wiki/Haynes_International_Motor_Museum
Helicopter Museum	in_Somerset	Transport	/wiki/The_Helicopter_Museum_(Weston)
Herschel Museum of Astronomy	in_Somerset	Other	/wiki/Herschel_Museum_of_Astronomy
Holburne Museum of Art	in_Somerset	Arts	/wiki/Holburne_Museum_of_Art
Ilchester Museum	in_Somerset	Local	/wiki/Ilchester_Museum
Jane Austen Centre	in_Somerset	Local	/wiki/Jane_Austen_Centre
King John's Hunting Lodge	in_Somerset	Historic	/wiki/King_John%27s_Hunting_Lodge,_Axbridge
Lambretta Scooter Museum	in_Somerset	Transport	/wiki/Lambretta_Scooter_Museum
Langport and River Parrett Visitor Centre	in_Somerset	Local	
Lytes Cary Manor	in_Somerset	Historic	/wiki/Lytes_Cary
Market House Museum	in_Somerset	Local	/wiki/Market_House_Museum
Montacute House	in_Somerset	Historic	/wiki/Montacute_House
Montacute TV Radio Toy Museum	in_Somerset	Arts	/w/index.php?title=Montacute_TV_Radio_Toy_Museum&action=edit&redlink=1
Muchelney Abbey	in_Somerset	Other	/wiki/Muchelney_Abbey
Museum of Bath Architecture	in_Somerset	Historic	/wiki/Museum_of_Bath_Architecture
Museum of Bath at Work	in_Somerset	Local	/wiki/Museum_of_Bath_at_Work
Museum of East Asian Art	in_Somerset	Arts	/wiki/Museum_of_East_Asian_Art,_Bath
Museum of Somerset	in_Somerset	Multiple	/wiki/Museum_of_Somerset
No. 1 Royal Crescent	in_Somerset	Historic	/wiki/Royal_Crescent#Current_use
Porlock Museum	in_Somerset	Local	/wiki/Porlock_Museum
Priest's House	in_Somerset	Other	/wiki/The_Priest%27s_House,_Muchelney
Radstock Museum	in_Somerset	Multiple	/wiki/Radstock_Museum
Roman Baths	in_Somerset	Historic	/wiki/Roman_Baths_(Bath)
Sally Lunn's House	in_Somerset	Historic	/wiki/Sally_Lunn%27s_House
Shoe Museum	in_Somerset	Industrial	/wiki/The_Shoe_Museum
Somerset and Dorset Railway Heritage Centre	in_Somerset	Transport	/wiki/Midsomer_Norton_railway_station#Somerset_and_Dorset_Railway_Heritage_Centre
Somerset and Dorset Railway Trust Museum	in_Somerset	Transport	/wiki/Washford_railway_station#Somerset_and_Dorset_Railway_Trust_Museum
Somerset Brick and Tile Museum	in_Somerset	Industrial	/wiki/Somerset_Brick_and_Tile_Museum
Somerset Cricket Museum	in_Somerset	Other	/wiki/Somerset_Cricket_Museum
Somerset Military Museum	in_Somerset	Other	/wiki/Somerset_Military_Museum
Somerset Rural Life Museum	in_Somerset	Other	/wiki/Somerset_Rural_Life_Museum
Stembridge Tower Mill	in_Somerset	Industrial	/wiki/Stembridge_Mill,_High_Ham
Treasurer's House	in_Somerset	Historic	/wiki/Treasurer%27s_House
Tropiquaria	in_Somerset	Multiple	/wiki/Tropiquaria
Tyntesfield	in_Somerset	Historic	/wiki/Tyntesfield
Victoria Art Gallery	in_Somerset	Arts	/wiki/Victoria_Art_Gallery
Watchet Boat Museum	in_Somerset	Transport	/wiki/Watchet_Boat_Museum
Wellington Museum	in_Somerset	Local	/wiki/Wellington_Museum,_Somerset
Wells and Mendip Museum	in_Somerset	Local	/wiki/Wells_and_Mendip_Museum
West Somerset Rural Life Museum and Victorian School	in_Somerset	Other	/wiki/West_Somerset_Rural_Life_Museum_and_Victorian_School
West Somerset Railway	in_Somerset	Transport	/wiki/West_Somerset_Railway
Weston-super-Mare Museum	in_Somerset	Local	/wiki/Weston-super-Mare_Museum
Westonzoyland Pumping Station Museum	in_Somerset	Other	/wiki/Westonzoyland_Pumping_Station_Museum
Willows and Wetlands Visitor Centre	in_Somerset	Industrial	/wiki/Willows_and_Wetlands_Visitor_Centre
Wincanton Museum	in_Somerset	Local	/wiki/Wincanton_Museum
Woodspring Priory	in_Somerset	Other	/wiki/Woodspring_Priory
Yeovil Railway Centre	in_Somerset	Transport	/wiki/Yeovil_Railway_Centre
