name	county	type	wikipedia_link
AirSpace Gallery	in_Staffordshire	Arts	/w/index.php?title=AirSpace_Gallery&action=edit&redlink=1
Ancient High House	in_Staffordshire	Historic	/wiki/Ancient_High_House
Apedale Heritage Centre	in_Staffordshire	Industrial	/wiki/Apedale_Heritage_Centre
Boscobel House	in_Staffordshire	Historic	/wiki/Boscobel_House
Bratch Pumping Station	in_Staffordshire	Other	/wiki/Bratch#Bratch_Pumping_Station
Brindley's Mill and the James Brindley Museum	in_Staffordshire	Industrial	/wiki/Brindley_Water_Mill
Cheddleton Flint Mill	in_Staffordshire	Industrial	/wiki/Cheddleton_Flint_Mill
Chillington Hall	in_Staffordshire	Historic	/wiki/Chillington_Hall
Claymills Pumping Station	in_Staffordshire	Other	/wiki/Claymills_Pumping_Station
Dudson Museum	in_Staffordshire	Industrial	
Erasmus Darwin House	in_Staffordshire	Historic	/wiki/Erasmus_Darwin_House
Etruria Industrial Museum	in_Staffordshire	Industrial	/wiki/Etruria_Industrial_Museum
Ford Green Hall	in_Staffordshire	Historic	/wiki/Ford_Green_Hall
Gladstone Pottery Museum	in_Staffordshire	Industrial	/wiki/Gladstone_Pottery_Museum
Izaak Walton's Cottage	in_Staffordshire	Historic	
Keele University Art Gallery	in_Staffordshire	Arts	/wiki/Keele_University
Kinver Edge and the Rock Houses	in_Staffordshire	Historic	/wiki/Kinver_Edge
Lichfield Museum	in_Staffordshire	Local	/wiki/Lichfield_Museum
Mill Meece Pumping Station	in_Staffordshire	Other	/wiki/Mill_Meece_Pumping_Station
Moorcroft Heritage Visitor Centre	in_Staffordshire	Industrial	
Moseley Old Hall	in_Staffordshire	Historic	/wiki/Moseley_Old_Hall
Museum of Cannock Chase	in_Staffordshire	Multiple	/w/index.php?title=Museum_of_Cannock_Chase&action=edit&redlink=1
National Brewery Centre	in_Staffordshire	Industrial	/wiki/National_Brewery_Centre
Newcastle Museum & Art Gallery	in_Staffordshire	Multiple	/w/index.php?title=Newcastle_Museum_%26_Art_Gallery&action=edit&redlink=1
Nicholson Museum & Art Gallery	in_Staffordshire	Arts	/w/index.php?title=Nicholson_Museum_%26_Art_Gallery&action=edit&redlink=1
Potteries Museum & Art Gallery	in_Staffordshire	Multiple	/wiki/Potteries_Museum_%26_Art_Gallery
Raven Mason Collection	in_Staffordshire	Arts	
Redfernâ€™s Cottage: Museum of Uttoxeter Life	in_Staffordshire	Local	/w/index.php?title=Redfern%E2%80%99s_Cottage&action=edit&redlink=1
Samuel Johnson Birthplace Museum	in_Staffordshire	Local	/wiki/Samuel_Johnson_Birthplace_Museum
Shire Hall Gallery	in_Staffordshire	Arts	/wiki/Shire_Hall_Gallery
Shugborough Hall	in_Staffordshire	Local	/wiki/Shugborough_Hall
Spode Works Visitor Centre	in_Staffordshire	Industrial	/wiki/Spode_Museum
Stafford Castle	in_Staffordshire	Historic	/wiki/Stafford_Castle
Staffordshire County Museum	in_Staffordshire	Local	/wiki/Staffordshire_County_Museum
Staffordshire Regiment Museum	in_Staffordshire	Other	/wiki/Staffordshire_Regiment_Museum
Staffordshire Yeomanry Museum	in_Staffordshire	Other	/wiki/Ancient_High_House
Tamworth Castle	in_Staffordshire	Historic	/wiki/Tamworth_Castle
Letocetum / Wall Roman Site	in_Staffordshire	Historic	/wiki/Letocetum
Wedgwood Museum	in_Staffordshire	Arts	/wiki/Wedgwood_Museum
Weston Park	in_Staffordshire	Historic	/wiki/Weston_Park
Whitmore Hall	in_Staffordshire	Historic	/wiki/Whitmore_Hall
