name	county	type	wikipedia_link
Acton Court	in_Gloucestershire	Other	/wiki/Acton_Court
Berkeley Castle	in_Gloucestershire	Other	/wiki/Berkeley_Castle
Blackfriars	in_Gloucestershire	Other	/wiki/Blackfriars,_Gloucester
Chavenage House	in_Gloucestershire	Other	/wiki/Chavenage_House
Chedworth Roman Villa	in_Gloucestershire	Other	/wiki/Chedworth_Roman_Villa
Clearwell Caves	in_Gloucestershire	Other	/wiki/Clearwell_Caves
Coleford Great Western Railway Museum	in_Gloucestershire	Other	/wiki/Coleford_Great_Western_Railway_Museum
Corinium Museum	in_Gloucestershire	Other	/wiki/Corinium_Museum
Cotswold Motoring Museum	in_Gloucestershire	Other	/wiki/Cotswold_Motoring_Museum
Court Barn	in_Gloucestershire	Other	/w/index.php?title=Court_Barn&action=edit&redlink=1
Dean Forest Railway	in_Gloucestershire	Other	/wiki/Dean_Forest_Railway
Dean Heritage Centre	in_Gloucestershire	Local	/wiki/Dean_Heritage_Centre
Dr. Jennerâ€™s House	in_Gloucestershire	Other	/wiki/Dr._Jenner%E2%80%99s_House
Dunkirk Mill	in_Gloucestershire	Other	/w/index.php?title=Dunkirk_Mill&action=edit&redlink=1
Dursley Heritage Centre	in_Gloucestershire	Other	
Dyrham Park	in_Gloucestershire	Other	/wiki/Dyrham_Park
Frenchay Village Museum	in_Gloucestershire	Other	
Gardens Gallery	in_Gloucestershire	Other	
Gigg Mill	in_Gloucestershire	Other	/w/index.php?title=Gigg_Mill&action=edit&redlink=1
The Museum of Gloucester	in_Gloucestershire	Local	/wiki/The_Museum_of_Gloucester
Gloucester Life	in_Gloucestershire	Other	/wiki/Gloucester_Life
Gloucester Waterways Museum	in_Gloucestershire	Historic	/wiki/Gloucester_Waterways_Museum
Hailes Abbey	in_Gloucestershire	Other	/wiki/Hailes_Abbey
Holst Birthplace Museum	in_Gloucestershire	Other	/w/index.php?title=Holst_Birthplace_Museum&action=edit&redlink=1
Hopewell Colliery Museum	in_Gloucestershire	Other	
Jet Age Museum	in_Gloucestershire	Other	/wiki/Jet_Age_Museum
John Moore Museum	in_Gloucestershire	Other	/w/index.php?title=John_Moore_Museum&action=edit&redlink=1
Keith Harding's World of Mechanical Music	in_Gloucestershire	Other	
Kingswood Heritage Museum	in_Gloucestershire	Other	/w/index.php?title=Kingswood_Heritage_Museum&action=edit&redlink=1
Lydney Park	in_Gloucestershire	Other	/wiki/Lydney_Park
Merchant's House	in_Gloucestershire	Other	/w/index.php?title=Merchant%E2%80%99s_House,_Tewkesbury&action=edit&redlink=1
Museum in the Park	in_Gloucestershire	Local	/wiki/Stratford_Park
Nature in Art	in_Gloucestershire	Other	/wiki/Nature_in_Art
Newark Park	in_Gloucestershire	Other	/wiki/Newark_Park
Owlpen Manor	in_Gloucestershire	Other	/wiki/Owlpen_Manor
Prema	in_Gloucestershire	Other	
Rodmarton Manor	in_Gloucestershire	Other	/wiki/Rodmarton_Manor
Sezincote House	in_Gloucestershire	Other	/wiki/Sezincote_House
Snowshill Manor	in_Gloucestershire	Other	/wiki/Snowshill_Manor
Soldiers of Gloucestershire Museum	in_Gloucestershire	Historic	/wiki/Soldiers_of_Gloucestershire_Museum
St. Mary's Mill	in_Gloucestershire	Other	
Stanway House	in_Gloucestershire	Other	/wiki/Stanway_House
Sudeley Castle	in_Gloucestershire	Other	/wiki/Sudeley_Castle
Tailor of Gloucester Beatrix Potter Museum and Shop	in_Gloucestershire	Other	
Tetbury Police Museum	in_Gloucestershire	Other	/w/index.php?title=Tetbury_Police_Museum&action=edit&redlink=1
Tewkesbury Borough Museum	in_Gloucestershire	Local	/wiki/Tewkesbury_Borough_Museum
Tewkesbury Heritage Centre	in_Gloucestershire	Other	
Thornbury and District Museum	in_Gloucestershire	Other	/w/index.php?title=Thornbury_and_District_Museum&action=edit&redlink=1
Wellington Aviation Museum	in_Gloucestershire	Other	/w/index.php?title=Wellington_Aviation_Museum&action=edit&redlink=1
The Wilson	in_Gloucestershire	Other	/wiki/The_Wilson_(Cheltenham)
Winchcombe Folk and Police Museum	in_Gloucestershire	Other	/w/index.php?title=Winchcombe_Folk_and_Police_Museum&action=edit&redlink=1
Woodchester Mansion	in_Gloucestershire	Other	/wiki/Woodchester_Mansion
Wotton-under-Edge Heritage Centre	in_Gloucestershire	Other	/w/index.php?title=Wotton-under-Edge_Heritage_Centre&action=edit&redlink=1
Yate Heritage Centre	in_Gloucestershire	Other	/w/index.php?title=Yate_Heritage_Centre&action=edit&redlink=1
