name	county	type	wikipedia_link
1940s Experience	in_Hertfordshire	Local	
Art and Design Gallery	in_Hertfordshire	Arts	/w/index.php?title=Art_and_Design_Gallery&action=edit&redlink=1
Ashwell Village Museum	in_Hertfordshire	Local	
Baldock Museum	in_Hertfordshire	Local	
British Schools Museum	in_Hertfordshire	Other	/wiki/British_Schools_Museum
Bushey Museum	in_Hertfordshire	Multiple	/wiki/Bushey_Museum
Cromer Windmill	in_Hertfordshire	Industrial	/wiki/Cromer_Windmill,_Ardeley
Dacorum Heritage Trust Ltd	in_Hertfordshire	Local	
Datchworth Museum	in_Hertfordshire	Local	
de Havilland Aircraft Museum	in_Hertfordshire	Transport	/wiki/De_Havilland_Aircraft_Museum
Elstree and Boreham Wood Museum	in_Hertfordshire	Local	/w/index.php?title=Elstree_and_Boreham_Wood_Museum&action=edit&redlink=1
Frogmore Paper Mill	in_Hertfordshire	Industrial	/wiki/John_Dickinson_Stationery#Frogmore_Paper_Mill
Gorham House	in_Hertfordshire	Historic	/wiki/Old_Gorhambury_House
International Garden Cities Exhibition	in_Hertfordshire	Historic	
Hatfield House	in_Hertfordshire	Historic	/wiki/Hatfield_House
Henry Moore Perry Green	in_Hertfordshire	Arts	/wiki/Henry_Moore_Foundation
Hertford Museum	in_Hertfordshire	Local	/wiki/Hertford_Museum
Knebworth House	in_Hertfordshire	Historic	/wiki/Knebworth_House
ICAS - Vilas Fine Art	in_Hertfordshire	Arts	/w/index.php?title=ICAS_-_Vilas_Fine_Art&action=edit&redlink=1
Letchworth Arts Centre	in_Hertfordshire	Arts	/w/index.php?title=Letchworth_Arts_Centre&action=edit&redlink=1
Lowewood Museum	in_Hertfordshire	Local	/w/index.php?title=Lowewood_Museum&action=edit&redlink=1
Mill Green Museum	in_Hertfordshire	Industrial	/wiki/Mill_Green_Museum
Museum of St Albans	in_Hertfordshire	Local	/wiki/Museum_of_St_Albans
Much Hadham Forge Museum	in_Hertfordshire	Historic	/w/index.php?title=Much_Hadham_Forge_Museum&action=edit&redlink=1
Natural History Museum at Tring	in_Hertfordshire	Other	/wiki/Natural_History_Museum_at_Tring
North Hertfordshire Museum	in_Hertfordshire	Multiple	/w/index.php?title=North_Hertfordshire_Museum&action=edit&redlink=1
Potters Bar Museum	in_Hertfordshire	Local	
Redbourn Museum	in_Hertfordshire	Local	
Redbournbury Mill	in_Hertfordshire	Industrial	/wiki/Redbournbury_Mill
Rhodes Arts Complex	in_Hertfordshire	Multiple	/wiki/Rhodes_Arts_Complex
Royston & District Museum and Art Gallery	in_Hertfordshire	Multiple	
Shaw's Corner	in_Hertfordshire	Historic	/wiki/Shaw%27s_Corner
St Albans Organ Theatre	in_Hertfordshire	Other	
Stevenage Museum	in_Hertfordshire	Local	/w/index.php?title=Stevenage_Museum&action=edit&redlink=1
Three Rivers Museum	in_Hertfordshire	Local	
Tring Local History Museum	in_Hertfordshire	Local	/w/index.php?title=Tring_Local_History_Museum&action=edit&redlink=1
Verulamium Museum	in_Hertfordshire	Historic	/wiki/Verulamium_Museum
Ware Museum	in_Hertfordshire	Local	/w/index.php?title=Ware_Museum&action=edit&redlink=1
Watford Museum	in_Hertfordshire	Local	/wiki/Watford_Museum
Welwyn Roman Baths	in_Hertfordshire	Historic	/wiki/Welwyn_Roman_Baths
